NO textures/texture-01.png
SO textures/texture-02.png
WE textures/texture-03.png
EA textures/texture-04.png

C 91,166,252
F 224,184,144

1111111111111111111111111
1000000000010000000000001
1000000000000000000000011
1000000000000000000000001
11000000000E0000000000001
1000000000000000000000001
1000000000000000000010001
1000000000000000000010001
1111111111111111111111111